#domain
hospital
#levelname
DFS_Trap
#colors
blue: 0, A, B
red: 1
green: 2
#initial
+++++++++++++
+           +
+ +++++++++ +
+ +       + +
+0          +
+++       + +
+++++++++++++
#goal
+++++++++++++
+           +
+ +++++++++ +
+ +       + +
+          0+
+++       + +
+++++++++++++
#end