#domain
hospital
#levelname
Hard_Mode2
#colors
blue: 0, A, B
red: 1, D
green: 2, C
#initial
+++++++++++++
+C2   A+++ 1+
+ + +++++++ +
+ +      D  +
+ + ++++ ++ +
+0+ ++++B++ +
+++++++++++++
#goal
+++++++++++++
+      +++B +
+ + +++++++ +
+ +         +
+ + ++++ ++ +
+ +A++++ ++ +
+++++++++++++
#end