#domain
hospital
#levelname
Hard_Mode3
#colors
blue: 0, A, B, C
red: 1
green: 2
orange: 3
#initial
++++++++++++++++++++
+ 2   A+         + +
+ + +++++++++1++++ +
+ +              +3+
+ + ++++ +++++++ + +
+0+ ++++B++C       +
++++++++++++++++++++
#goal
++++++++++++++++++++
+      +        B+C+
+ + +++++++++ ++++ +
+ +              + +
+ + ++++ +++++++ + +
+ +A++++ ++        +
++++++++++++++++++++
#end