#domain
hospital
#levelname
MAP_Jam
#colors
blue: 0, A, B
red: 1
green: 2
#initial
+++++++++++++
+ 2   A+++ 1+
+ + +++++++ +
+ +         +
+ + ++++ ++ +
+0+ ++++B++ +
+++++++++++++
#goal
+++++++++++++
+      +++B +
+ + +++++++ +
+ +         +
+ + ++++ ++ +
+ +A++++ ++ +
+++++++++++++
#end