#domain
hospital
#levelname
Battlefield
#colors
blue: 0
red: 1, A 
green:2, B
#initial
++++++++++++++++++
+               0+
+       ++++++++++
+          A B   +
+         + + +  +
+         +1+2+  +
++++++++++++++++++
#goal
++++++++++++++++++
+                +
+       ++++++++++
+               0+
+         + + +  +
+         + + +  +
++++++++++++++++++
#end