#domain
hospital
#levelname
Make_way
#colors
blue: 0
red: 1
#initial
+++++++++++++
+         + +
+ +  ++++++ +
+ +  +      +
+ +  ++++++ +
+0+        1+
+++++++++++++
#goal
+++++++++++++
+         + +
+ +  ++++++ +
+ +  +0     +
+ +  ++++++ +
+ +         +
+++++++++++++
#end