#domain
hospital
#levelname
Make_way
#colors
blue: 0
red: 1
green: 2
purple: 3
#initial
+++++++++++++
+        +1 +
+ +   ++++  +
+ +   +     +
+ +   ++++  +
+0+         +
+++++++++++++
#goal
+++++++++++++
+         + +
+ +  ++++++ +
+ +  +0     +
+ +  ++++++ +
+1+         +
+++++++++++++
#end