#domain
hospital
#levelname
MAP_Jam
#colors
blue: 0
red: 1
green: 2
yellow: 3
#initial
+++++++++++++
+        + 0+
+     ++++  +
+           +
+       +  2+
+3      + 1 +
+++++++++++++
#goal
+++++++++++++
+       1+ 3+
+     ++++  +
+           +
+       +   +
+2      +  0+
+++++++++++++
#end