#domain
hospital
#levelname
Ninja_way
#colors
blue: 0, A, B, C
#initial
+++++++++++++
++ +++ +++ ++
+   +   +   +
++ +++ +++ ++
+ A   B   C +
+     0     +
+++++++++++++
#goal
+++++++++++++
++A+++B+++C++
+   +   +   +
++ +++ +++ ++
+           +
+           +
+++++++++++++
#end