#domain
hospital
#levelname
Two_halves
#colors
blue: 0, A
red:1,B
#initial
+++++++++++++++++++++++++++
+                  +    B1+
+            +++++++      +
+            +            +
+      +++++++            +
+0A    +                  +
+++++++++++++++++++++++++++
#goal
+++++++++++++++++++++++++++
+                 A+      +
+            +++++++      +
+            +            +
+      +++++++            +
+      +B                 +
+++++++++++++++++++++++++++
#end