#domain
hospital
#levelname
Make_way
#colors
blue: 1, A
red: 0, B
#initial
+++++++++++
+1        +
++++ ++++++
++++ ++++++
++++B++++++
++++0++++++
++++A++++++
+++++++++++
#goal
+++++++++++
+       AB+
++++ ++++++
++++ ++++++
++++ ++++++
++++ ++++++
++++ ++++++
+++++++++++
#end