#domain
hospital
#levelname
Wierdo
#colors
blue: 0, A
red:1,B
#initial
++++++++++++++++
+0A +++++++++  +
+      +++++   +
+++++ +++++    +
+++     +++ ++++
+++++++      +++
++++++++++++++++
#goal
++++++++++++++++
+   +++++++++A +
+      +++++   +
+++++ +++++    +
+++     +++ ++++
+++++++      +++
++++++++++++++++
#end